** Prologue Channel ON **

Hurrying through the rainswept November night, you're glad to see the bright lights of the Opera House. It's surprising that there aren't more people about but, hey, what do you expect in a cheap demo game...?
** Main Channel ON **
Cloak of Darkness QC, A basic IF demonstration by David Cornelson
Copyright © 2015 by David Cornelson
Release 1 / Serial number 150419 / Inform 7 Build 6L38 (I6 lib/v6.33 lib 6/12N SD)

You are standing in a spacious hall, splendidly decorated in red and gold, with glittering chandeliers overhead. The entrance from the street is to the north, and there are doorways south and west.

>l
You are standing in a spacious hall, splendidly decorated in red and gold, with glittering chandeliers overhead. The entrance from the street is to the north, and there are doorways south and west.

>i
You are carrying:
  a velvet cloak (being worn)

>s
It is pitch dark, and you can't see a thing.

>w
Blundering around in the dark isn't a good idea!

>l
In the dark? You could easily disturb something.

>n
You are standing in a spacious hall, splendidly decorated in red and gold, with glittering chandeliers overhead. The entrance from the street is to the north, and there are doorways south and west.

>w
The walls of this small room were clearly once lined with hooks, though now only one remains. The exit is a door to the east.

>put cloak on hook
(first taking it off)
You put the velvet cloak on the small brass hook.

[Your score has just gone up by one point.]

>w
You can't go that way.

>e
You are standing in a spacious hall, splendidly decorated in red and gold, with glittering chandeliers overhead. The entrance from the street is to the north, and there are doorways south and west.

>s
The bar, much rougher than you'd have guessed after the opulence of the foyer to the north, is completely empty. There seems to be some sort of message scrawled in the sawdust on the floor.

>read message
The message has been carelessly trampled, making it difficult to read. You can just distinguish the words...

    *** You have lost ***

In that game you scored 1 out of a possible 2, in 12 turns.

Would you like to RESTART, RESTORE a saved game, QUIT or UNDO the last command?

>restart
Hurrying through the rainswept November night, you're glad to see the bright lights of the Opera House. It's surprising that there aren't more people about but, hey, what do you expect in a cheap demo game...?

Cloak of Darkness QC
A basic IF demonstration. by David Cornelson
Release 1 / Serial number 150419 / Inform 7 build 6L38 (I6/v6.33 lib 6/12N) SD

You are standing in a spacious hall, splendidly decorated in red and gold, with glittering chandeliers overhead. The entrance from the street is to the north, and there are doorways south and west.

>w
The walls of this small room were clearly once lined with hooks, though now only one remains. The exit is a door to the east.

* * *

>put cloak on hook
(first taking it off)
You put the velvet cloak on the small brass hook.

[Your score has just gone up by one point.]

>e
You are standing in a spacious hall, splendidly decorated in red and gold, with glittering chandeliers overhead. The entrance from the street is to the north, and there are doorways south and west.

* * *

>s
The bar, much rougher than you'd have guessed after the opulence of the foyer to the north, is completely empty. There seems to be some sort of message scrawled in the sawdust on the floor.

>read message
The message, neatly marked in the sawdust, reads...

    *** The End ***

In that game you scored 2 out of a possible 2, in 5 turns.

Would you like to RESTART, RESTORE a saved game, QUIT or UNDO the last command?

* * *

>l
You are standing in a spacious hall, splendidly decorated in red and gold, with glittering chandeliers overhead. The entrance from the street is to the north, and there are doorways south and west.

>w
The walls of this small room were clearly once lined with hooks, though now only one remains. The exit is a door to the east.

* * *

>put cloak on hook
(first taking it off)
You put the velvet cloak on the small brass hook.

[Your score has just gone up by one point.]

>restart
Are you sure you want to restart?

>y
Hurrying through the rainswept November night, you're glad to see the bright lights of the Opera House. It's surprising that there aren't more people about but, hey, what do you expect in a cheap demo game...?

Cloak of Darkness QC
A basic IF demonstration. by David Cornelson
Release 1 / Serial number 150419 / Inform 7 build 6L38 (I6/v6.33 lib 6/12N) SD

You are standing in a spacious hall, splendidly decorated in red and gold, with glittering chandeliers overhead. The entrance from the street is to the north, and there are doorways south and west.

>trace 5
[Parser tracing set to level 5.]

>w
[ "w" w ]
   [NounDomain called at word 1
   seeking definite object
    Trying the north (588410) at word 1
Parse_name called
Pass 1: 0 Pass 2: 0 Pass 3: 0
    Trying the northeast (588442) at word 1
Parse_name called
Pass 1: 0 Pass 2: 0 Pass 3: 0
    Trying the northwest (588474) at word 1
Parse_name called
Pass 1: 0 Pass 2: 0 Pass 3: 0
    Trying the south (588506) at word 1
Parse_name called
Pass 1: 0 Pass 2: 0 Pass 3: 0
    Trying the southeast (588538) at word 1
Parse_name called
Pass 1: 0 Pass 2: 0 Pass 3: 0
    Trying the southwest (588570) at word 1
Parse_name called
Pass 1: 0 Pass 2: 0 Pass 3: 0
    Trying the east (588602) at word 1
Parse_name called
Pass 1: 0 Pass 2: 0 Pass 3: 0
    Trying the west (588634) at word 1
Parse_name called
Pass 1: 1 Pass 2: 1 Pass 3: 1
    Matched (1)
    Trying the up (588666) at word 1
Parse_name called
Pass 1: 0 Pass 2: 0 Pass 3: 0
    Trying the down (588698) at word 1
Parse_name called
Pass 1: 0 Pass 2: 0 Pass 3: 0
    Trying the inside (588730) at word 1
Parse_name called
Pass 1: 0 Pass 2: 0 Pass 3: 0
    Trying the outside (588762) at word 1
Parse_name called
Pass 1: 0 Pass 2: 0 Pass 3: 0
   [ND made 1 matches]

The walls of this small room were clearly once lined with hooks, though now only one remains. The exit is a door to the east.

* * *

>w
The walls of this small room were clearly once lined with hooks, though now only one remains. The exit is a door to the east.

>hang cloak
(on the velvet cloak)
You can't put something on top of itself.

>hang cloak on hook
(first taking it off)
You put the velvet cloak on the small brass hook.

[Your score has just gone up by one point.]

* * *

>w
The walls of this small room were clearly once lined with hooks, though now only one remains. The exit is a door to the east.

>put cloak on hook
(first taking it off)
** Main Channel ON **You put the velvet cloak on the small brass hook.

[Your score has just gone up by one point.]

>e
You are standing in a spacious hall, splendidly decorated in red and gold, with glittering chandeliers overhead. The entrance from the street is to the north, and there are doorways south and west.

* * *

>s
The bar, much rougher than you'd have guessed after the opulence of the foyer to the north, is completely empty. There seems to be some sort of message scrawled in the sawdust on the floor.

>read message
** score message channel ON **
The message, neatly marked in the sawdust, reads...
** Main Channel ON **

    *** The End ***

In that game you scored 2 out of a possible 2, in 5 turns.

Would you like to RESTART, RESTORE a saved game, QUIT or UNDO the last command?
** Prompt Channel ON **
> ** Main Channel ON **